############
#@         #
#          #
#        $.#
############